RD,TS_received,TS_sent,AK,RoundTrip,
46761,51875,2024-12-17_15-18-59-487820,51876,5114,
51882,57007,2024-12-17_15-19-04-752671,57008,5125,
57009,62135,2024-12-17_15-19-10-185043,62136,5126,
62140,
67260,67311,2024-12-17_15-19-19-942666,67312,51,
72375,77480,2024-12-17_15-19-25-063025,77481,5105,
77484,82594,2024-12-17_15-19-30-278726,82598,5110,
82603,87719,2024-12-17_15-19-35-389487,87720,5116,
87724,92832,2024-12-17_15-19-40-423103,92833,5108,
92839,92887,2024-12-17_15-19-45-514913,92890,48,
97945,103068,2024-12-17_15-19-50-982308,103070,5123,
103075,108196,2024-12-17_15-19-55-868009,108197,5121,
108202,113303,2024-12-17_15-20-01-183386,113305,5101,
113308,118424,2024-12-17_15-20-06-049683,118425,5116,
118429,123536,2024-12-17_15-20-12-004596,123540,5107,
123543,128660,2024-12-17_15-20-16-462079,128661,5117,
128664,128714,2024-12-17_15-20-21-343535,128715,50,
133769,133834,2024-12-17_15-20-26-457814,133836,65,
138881,143983,2024-12-17_15-20-31-599726,143984,5102,
143987,149102,2024-12-17_15-20-36-728712,149103,5115,
149107,149151,2024-12-17_15-20-41-782753,149153,44,
154218,154267,2024-12-17_15-20-46-882596,154271,49,
159325,159345,2024-12-17_15-20-51-975743,159346,20,
164451,164484,2024-12-17_15-20-57-116819,164485,33,
169559,169589,2024-12-17_15-21-02-211905,169590,30,
174670,174695,2024-12-17_15-21-07-321696,174697,25,
179777,179802,2024-12-17_15-21-12-434652,179804,25,
184885,184913,2024-12-17_15-21-17-547336,184914,28,
189993,190020,2024-12-17_15-21-22-652318,190021,27,
195100,195125,2024-12-17_15-21-27-757097,195126,25,
200213,205328,2024-12-17_15-21-33-005592,205333,5115,
205334,205362,2024-12-17_15-21-37-987842,205363,28,
210443,210465,2024-12-17_15-21-43-100033,210466,22,
215550,215562,2024-12-17_15-21-48-197462,215564,12,
220658,220746,2024-12-17_15-21-53-335850,225777,88,
225780,225806,2024-12-17_15-21-58-439596,225807,26,
230909,230963,2024-12-17_15-22-03-581341,230965,54,
236026,236071,2024-12-17_15-22-08-702380,236075,45,
241147,241183,2024-12-17_15-22-13-818679,241184,36,
246270,251375,2024-12-17_15-22-19-143087,251376,5105,
251376,251421,2024-12-17_15-22-24-028860,251423,45,
256489,261601,2024-12-17_15-22-29-216159,261602,5112,
261609,266726,2024-12-17_15-22-34-360262,266727,5117,
266735,271854,2024-12-17_15-22-39-396923,271858,5119,
271862,271887,2024-12-17_15-22-44-510761,271888,25,
276974,277011,2024-12-17_15-22-49-647038,277013,37,
282106,282140,2024-12-17_15-22-54-775319,282141,34,
287214,292333,2024-12-17_15-22-59-997896,292338,5119,
292338,292409,2024-12-17_15-23-04-996295,292411,71,
297446,297465,2024-12-17_15-23-10-100023,297466,19,
302554,302590,2024-12-17_15-23-15-223039,302591,36,
307671,307740,2024-12-17_15-23-20-373602,307741,69,
312796,312829,2024-12-17_15-23-25-458771,312831,33,
317915,317947,2024-12-17_15-23-30-574772,317948,32,
323050,323087,2024-12-17_15-23-35-718824,323088,37,
328168,333282,2024-12-17_15-23-40-930625,333283,5114,
333287,338416,2024-12-17_15-23-45-976012,338417,5129,
338420,343535,2024-12-17_15-23-51-129425,343536,5115,
343539,348655,2024-12-17_15-23-56-335242,348656,5116,
348659,353763,2024-12-17_15-24-01-447988,353765,5104,
353772,353864,2024-12-17_15-24-06-477141,353865,92,
358893,358926,2024-12-17_15-24-11-560487,358927,33,
364015,364091,2024-12-17_15-24-16-691999,364092,76,
369136,374251,2024-12-17_15-24-21-994892,374252,5115,
374255,374305,2024-12-17_15-24-26-935193,374308,50,
379370,384493,2024-12-17_15-24-32-058956,384494,5123,
384497,389600,2024-12-17_15-24-37-646106,389601,5103,
389608,394744,2024-12-17_15-24-42-790245,394746,5136,
394749,399865,2024-12-17_15-24-47-488709,399866,5116,
399869,404995,2024-12-17_15-24-52-635320,404996,5126,
405000,410114,2024-12-17_15-24-57-736917,410115,5114,
410118,410192,2024-12-17_15-25-02-792324,410194,74,
415237,415289,2024-12-17_15-25-07-902975,415304,52,
420353,420386,2024-12-17_15-25-13-021770,420387,33,
425480,430597,2024-12-17_15-25-18-293034,430598,5117,
430599,430634,2024-12-17_15-25-23-269570,430669,35,
435710,435803,2024-12-17_15-25-28-431184,435804,93,
440818,440843,2024-12-17_15-25-33-476114,440844,25,
445924,445949,2024-12-17_15-25-38-579803,445951,25,
451061,451087,2024-12-17_15-25-43-722162,451088,26,
456168,461275,2024-12-17_15-25-48-944614,461276,5107,
461282,466401,2024-12-17_15-25-54-090609,466402,5119,
466406,471520,2024-12-17_15-25-59-087625,471521,5114,
471524,476635,2024-12-17_15-26-04-526224,476640,5111,
476643,476736,2024-12-17_15-26-09-363944,476738,93,
481760,486883,2024-12-17_15-26-14-864411,486885,5123,
486890,492019,2024-12-17_15-26-19-691056,492020,5129,
492028,492052,2024-12-17_15-26-24-687821,492054,24,
497135,0,,502249,-497135,
502252,507371,2024-12-17_15-26-34-990680,507377,5119,
507384,507418,2024-12-17_15-26-40-050030,507423,34,
512481,512495,2024-12-17_15-26-45-128838,512511,14,
517589,517662,2024-12-17_15-26-50-290647,517663,73,
522697,522760,2024-12-17_15-26-55-394229,522761,63,
527808,527833,2024-12-17_15-27-00-464927,527835,25,
532917,538029,2024-12-17_15-27-05-644263,538033,5112,
538040,543169,2024-12-17_15-27-10-767385,543171,5129,
543174,543206,2024-12-17_15-27-15-840074,543208,32,
548278,553385,2024-12-17_15-27-21-008927,553386,5107,
553392,553424,2024-12-17_15-27-26-058710,553425,32,
558497,558529,2024-12-17_15-27-31-150261,558530,32,
563606,563643,2024-12-17_15-27-36-270927,563645,37,
568714,568741,2024-12-17_15-27-41-376082,568742,27,
573849,573904,2024-12-17_15-27-46-525796,573908,55,
578957,578983,2024-12-17_15-27-51-617962,578984,26,
584067,589179,2024-12-17_15-27-56-720012,589181,5112,
589187,589242,2024-12-17_15-28-01-870978,589244,55,
594290,594314,2024-12-17_15-28-06-948406,594315,24,
599402,599441,2024-12-17_15-28-12-057712,599442,39,
604509,604560,2024-12-17_15-28-17-194726,604561,51,
609627,609653,2024-12-17_15-28-22-285950,609654,26,
614733,614772,2024-12-17_15-28-27-387047,614773,39,
619842,624974,2024-12-17_15-28-32-535580,624975,5132,
624978,625015,2024-12-17_15-28-37-641496,625016,37,
630107,630165,2024-12-17_15-28-42-780977,630166,58,
635216,635265,2024-12-17_15-28-47-866849,635267,49,
640331,640372,2024-12-17_15-28-53-001251,640373,41,
645444,645482,2024-12-17_15-28-58-113352,645484,38,
650555,650575,2024-12-17_15-29-03-207813,650576,20,
655666,655701,2024-12-17_15-29-08-335791,655702,35,
660781,660842,2024-12-17_15-29-13-458923,660843,61,
665900,665939,2024-12-17_15-29-18-570580,665941,39,
671008,676121,2024-12-17_15-29-23-728903,676125,5113,
676130,676165,2024-12-17_15-29-28-783423,676166,35,
681264,681298,2024-12-17_15-29-33-926655,681300,34,
686387,686484,2024-12-17_15-29-39-117786,686486,97,
691503,696634,2024-12-17_15-29-44-260817,696635,5131,
696638,696683,2024-12-17_15-29-49-300607,696684,45,
701772,701805,2024-12-17_15-29-54-427952,701806,33,
706882,706980,2024-12-17_15-29-59-586061,706981,98,
711996,712031,2024-12-17_15-30-04-659516,712035,35,
717114,722234,2024-12-17_15-30-09-852039,722236,5120,
722243,727363,2024-12-17_15-30-14-977318,727364,5120,
727367,727401,2024-12-17_15-30-20-028938,727402,34,
732488,732525,2024-12-17_15-30-25-159473,732526,37,
737596,742715,2024-12-17_15-30-30-318569,742719,5119,
742723,742780,2024-12-17_15-30-35-393639,742785,57,
747844,747881,2024-12-17_15-30-40-505118,747887,37,
752959,752992,2024-12-17_15-30-45-622697,752994,33,
758073,758131,2024-12-17_15-30-50-759550,758132,58,
763197,763218,2024-12-17_15-30-55-852051,763220,21,
768311,768352,2024-12-17_15-31-00-982803,768356,41,
773424,773441,2024-12-17_15-31-06-072106,773442,17,
778536,778557,2024-12-17_15-31-11-191826,778559,21,
783643,783680,2024-12-17_15-31-16-293490,783681,37,
788760,788781,2024-12-17_15-31-21-416092,788782,21,
793876,793905,2024-12-17_15-31-26-539555,793906,29,
798989,799021,2024-12-17_15-31-31-654692,799022,32,
804119,804160,2024-12-17_15-31-36-792372,804162,41,
809226,809277,2024-12-17_15-31-41-901751,809279,51,
814357,819472,2024-12-17_15-31-47-063008,819474,5115,
819484,819511,2024-12-17_15-31-52-143036,819513,27,
824582,824595,2024-12-17_15-31-57-229363,824598,13,
829689,829715,2024-12-17_15-32-02-347825,829716,26,
834820,834849,2024-12-17_15-32-07-482714,834850,29,
839928,839966,2024-12-17_15-32-12-593064,839967,38,
845036,845061,2024-12-17_15-32-17-692830,845062,25,
850149,850189,2024-12-17_15-32-22-806817,850190,40,
855256,855289,2024-12-17_15-32-27-918939,855290,33,
860363,860421,2024-12-17_15-32-33-054172,860423,58,
865475,865485,2024-12-17_15-32-38-120125,865486,10,
870579,870590,2024-12-17_15-32-43-223581,870591,11,
875698,875727,2024-12-17_15-32-48-362005,875731,29,
880830,880865,2024-12-17_15-32-53-491685,880866,35,
885938,885966,2024-12-17_15-32-58-600436,885967,28,
891046,891059,2024-12-17_15-33-03-692630,891063,13,
896173,896198,2024-12-17_15-33-08-830778,896200,25,
901282,901322,2024-12-17_15-33-13-946882,901323,40,
906390,906422,2024-12-17_15-33-19-050376,906424,32,
911498,916604,2024-12-17_15-33-24-239001,916607,5106,
916611,916623,2024-12-17_15-33-29-254203,916624,12,
921755,921802,2024-12-17_15-33-34-434445,921807,47,
926863,926914,2024-12-17_15-33-39-542633,926915,51,
931972,932002,2024-12-17_15-33-44-629135,932003,30,
937079,937133,2024-12-17_15-33-49-768069,937134,54,
942186,942215,2024-12-17_15-33-54-841904,942220,29,
947304,947344,2024-12-17_15-33-59-976769,947346,40,
952412,952424,2024-12-17_15-34-05-059781,952440,12,
957520,962626,2024-12-17_15-34-10-251719,962631,5106,
962632,962678,2024-12-17_15-34-15-304301,962680,46,
967740,967782,2024-12-17_15-34-20-390354,967783,42,
972848,972882,2024-12-17_15-34-25-513149,972883,34,
977956,983063,2024-12-17_15-34-30-700006,983068,5107,
983071,983108,2024-12-17_15-34-35-738929,983110,37,
988176,993290,2024-12-17_15-34-40-934363,993294,5114,
993298,993323,2024-12-17_15-34-45-953069,993329,25,
998402,998431,2024-12-17_15-34-51-064582,998433,29,
1003510,1003539,2024-12-17_15-34-56-168860,1003540,29,
1008618,1008652,2024-12-17_15-35-01-282119,1008653,34,
1013763,1013840,2024-12-17_15-35-06-470227,1013841,77,
1018871,1023993,2024-12-17_15-35-12-074565,1023997,5122,
1024000,
1029120,1034250,2024-12-17_15-35-23-795829,1034252,5130,
1034253,1034303,2024-12-17_15-35-26-926474,1034304,50,
1039374,1039430,2024-12-17_15-35-32-045418,1039431,56,
1044493,1044524,2024-12-17_15-35-37-151090,1044528,31,
1049613,1054719,2024-12-17_15-35-42-964199,1054720,5106,
1054724,1059842,2024-12-17_15-35-48-035059,1059843,5118,
1059850,1064961,2024-12-17_15-35-53-494089,1064962,5111,
1064963,1065005,2024-12-17_15-35-57-633889,1065007,42,
1070080,1070140,2024-12-17_15-36-02-762456,1070141,60,
1075209,
1080320,1085440,2024-12-17_15-36-15-457016,1085445,5120,
1085446,1085498,2024-12-17_15-36-18-117756,1085499,52,
1090560,1090592,2024-12-17_15-36-23-225218,1090604,32,
1095671,1100784,2024-12-17_15-36-28-416533,1100786,5113,
1100792,1105901,2024-12-17_15-36-33-544460,1105902,5109,
1105905,1105963,2024-12-17_15-36-38-590147,1105965,58,
1111024,1116137,2024-12-17_15-36-43-766845,1116140,5113,
1116143,1121245,2024-12-17_15-36-48-874272,1121247,5102,
1121250,1121327,2024-12-17_15-36-53-947935,1121328,77,
1126360,1131485,2024-12-17_15-37-00-230273,1131486,5125,
1131487,1136601,2024-12-17_15-37-04-756996,1136603,5114,
1136606,1141724,2024-12-17_15-37-11-180306,1141726,5118,
1141733,1146857,2024-12-17_15-37-15-093697,1146858,5124,
1146861,1146937,2024-12-17_15-37-19-558771,1146939,76,
1151983,1157110,2024-12-17_15-37-24-764750,1157111,5127,
1157117,1157149,2024-12-17_15-37-29-775608,1157150,32,
1162240,1162320,2024-12-17_15-37-34-951353,1162321,80,
1167359,1172483,2024-12-17_15-37-40-792065,1172484,5124,
1172491,
1177615,1182741,2024-12-17_15-37-50-578607,1182743,5126,
1182747,1187862,2024-12-17_15-37-55-584397,1187864,5115,
1187867,1192970,2024-12-17_15-38-01-717447,1192971,5103,
1192974,1193002,2024-12-17_15-38-05-635041,1193003,28,
1198081,1203187,2024-12-17_15-38-11-635709,1203188,5106,
1203194,1208299,2024-12-17_15-38-15-904492,1208300,5105,
1208304,1208366,2024-12-17_15-38-20-991180,1208367,62,
1213418,
1218533,1223644,2024-12-17_15-38-31-636807,1223646,5111,
1223646,1228752,2024-12-17_15-38-36-763699,1228753,5106,
1228758,
1233873,1238992,2024-12-17_15-38-49-809084,1238993,5119,
1238994,1244123,2024-12-17_15-38-52-833299,1244124,5129,
1244125,1244162,2024-12-17_15-38-56-794141,1244163,37,
1249233,1254369,2024-12-17_15-39-02-549448,1254370,5136,
1254373,1259472,2024-12-17_15-39-09-908939,1259474,5099,
1259475,
1264595,1269734,2024-12-17_15-39-19-902832,1269736,5139,
1269737,
1274854,
1279966,1285085,2024-12-17_15-39-33-251486,1285086,5119,
1285093,1285145,2024-12-17_15-39-37-776951,1285147,52,
1290211,1290292,2024-12-17_15-39-42-908830,1290294,81,
1295317,1295361,2024-12-17_15-39-47-996036,1295362,44,
1300426,1305545,2024-12-17_15-39-54-128066,1305548,5119,
1305551,