RD,TS_received,TS_sent,AK,RoundTrip,
145777,150883,2024-12-14_20-04-40-889913,150884,5106,
150887,150900,2024-12-14_20-04-45-900342,150901,13,
155993,161099,2024-12-14_20-04-51-006209,161100,5106,
161103,161121,2024-12-14_20-04-56-118183,161122,18,
166215,166241,2024-12-14_20-05-01-243314,166242,26,
171323,171349,2024-12-14_20-05-06-341370,171350,26,
176431,176470,2024-12-14_20-05-11-463581,176471,39,
181619,181659,2024-12-14_20-05-16-645403,181660,40,
186731,186771,2024-12-14_20-05-21-757416,186772,40,
191838,191869,2024-12-14_20-05-26-863794,191870,31,
196970,196991,2024-12-14_20-05-31-993701,196992,21,
202077,202134,2024-12-14_20-05-37-121122,202135,57,
207184,207197,2024-12-14_20-05-42-199485,207199,13,
212292,212323,2024-12-14_20-05-47-316070,212327,31,
217400,217427,2024-12-14_20-05-52-419374,217428,27,
222542,222567,2024-12-14_20-05-57-565208,222568,25,
227662,227714,2024-12-14_20-06-02-692289,227716,52,
232781,232800,2024-12-14_20-06-07-803586,232806,19,
237892,237939,2024-12-14_20-06-12-936772,237940,47,
243006,243039,2024-12-14_20-06-18-041438,243040,33,
248117,248151,2024-12-14_20-06-23-151501,248152,34,
253245,253297,2024-12-14_20-06-28-283778,253298,52,
258371,258399,2024-12-14_20-06-33-402054,258404,28,
263491,263522,2024-12-14_20-06-38-523381,263525,31,
268609,268662,2024-12-14_20-06-43-649597,268675,53,
273724,273750,2024-12-14_20-06-48-749678,273751,26,
278834,278876,2024-12-14_20-06-53-866022,278877,42,
283953,283990,2024-12-14_20-06-58-991516,283991,37,
289060,289088,2024-12-14_20-07-04-087778,289089,28,
294194,294226,2024-12-14_20-07-09-221181,294227,32,
299308,299355,2024-12-14_20-07-14-342534,299360,47,
304434,304452,2024-12-14_20-07-19-453422,304454,18,
309560,309597,2024-12-14_20-07-24-593859,309598,37,
314680,314713,2024-12-14_20-07-29-707705,314717,33,
319799,319813,2024-12-14_20-07-34-815381,319815,14,
324908,330031,2024-12-14_20-07-40-043276,330032,5123,
330038,330081,2024-12-14_20-07-45-067563,330082,43,
335151,335182,2024-12-14_20-07-50-179283,335183,31,
340280,340310,2024-12-14_20-07-55-300111,340311,30,
345395,345426,2024-12-14_20-08-00-419730,345427,31,
350515,350555,2024-12-14_20-08-05-554338,350556,40,
355648,355681,2024-12-14_20-08-10-676657,355682,33,
360755,360768,2024-12-14_20-08-15-766425,360769,13,
365872,370988,2024-12-14_20-08-20-920404,370993,5116,
370996,371033,2024-12-14_20-08-26-025465,371034,37,
376113,376153,2024-12-14_20-08-31-145937,376154,40,
381232,381266,2024-12-14_20-08-36-264647,381271,34,
386355,386390,2024-12-14_20-08-41-383299,386391,35,
391477,391510,2024-12-14_20-08-46-509911,391511,33,
396584,396620,2024-12-14_20-08-51-618195,396621,36,
401709,401763,2024-12-14_20-08-56-763241,401764,54,
406831,406855,2024-12-14_20-09-01-858166,406859,24,
411951,412019,2024-12-14_20-09-07-005289,412020,68,
417074,417112,2024-12-14_20-09-12-113500,417113,38,
422191,422227,2024-12-14_20-09-17-228072,422228,36,
427298,427321,2024-12-14_20-09-22-319800,427322,23,
432419,432499,2024-12-14_20-09-27-453462,432500,80,
437525,437545,2024-12-14_20-09-32-543661,437546,20,
442634,442672,2024-12-14_20-09-37-661290,442673,38,
447745,447776,2024-12-14_20-09-42-776870,447777,31,
452853,452864,2024-12-14_20-09-47-865307,452866,11,
457979,458015,2024-12-14_20-09-53-015489,458016,36,
463166,463188,2024-12-14_20-09-58-184256,463189,22,
468303,468355,2024-12-14_20-10-03-347680,468356,52,
473410,473430,2024-12-14_20-10-08-432747,473434,20,
478516,478523,2024-12-14_20-10-13-525862,478530,7,
483652,483681,2024-12-14_20-10-18-682647,483682,29,
488761,488796,2024-12-14_20-10-23-798387,488798,35,
493868,493895,2024-12-14_20-10-28-886350,493896,27,
498980,499023,2024-12-14_20-10-34-019467,499024,43,
504087,504118,2024-12-14_20-10-39-110511,504119,31,
509197,509231,2024-12-14_20-10-44-227274,509232,34,
514304,514325,2024-12-14_20-10-49-327070,514327,21,
519439,519476,2024-12-14_20-10-54-470105,519477,37,
524546,524577,2024-12-14_20-10-59-571657,524578,31,
529657,529716,2024-12-14_20-11-04-676331,529717,59,
534766,534792,2024-12-14_20-11-09-791887,534794,26,
539875,539898,2024-12-14_20-11-14-898260,539899,23,
544982,545002,2024-12-14_20-11-19-997122,545003,20,
550108,550139,2024-12-14_20-11-25-136850,550140,31,
555222,555273,2024-12-14_20-11-30-270351,555275,51,
560323,565431,2024-12-14_20-11-35-390840,565432,5108,
565434,565466,2024-12-14_20-11-40-468621,565468,32,
570541,570567,2024-12-14_20-11-45-560725,570568,26,
575669,575733,2024-12-14_20-11-50-733320,575734,64,
580787,580840,2024-12-14_20-11-55-838552,580842,53,
585896,585931,2024-12-14_20-12-00-909881,585932,35,
591003,591041,2024-12-14_20-12-06-027937,591042,38,
596112,596124,2024-12-14_20-12-11-125398,596125,12,
601223,601254,2024-12-14_20-12-16-253500,601255,31,
606330,606370,2024-12-14_20-12-21-370110,606371,40,
611437,611453,2024-12-14_20-12-26-453561,611454,16,
616558,616574,2024-12-14_20-12-31-575815,616575,16,
621665,621691,2024-12-14_20-12-36-693276,621692,26,
626773,626807,2024-12-14_20-12-41-801615,626808,34,
631886,631913,2024-12-14_20-12-46-910517,631914,27,
636995,637013,2024-12-14_20-12-52-010812,637015,18,
642131,642173,2024-12-14_20-12-57-170994,642174,42,
647273,647302,2024-12-14_20-13-02-298783,647303,29,
652392,652422,2024-12-14_20-13-07-422761,652424,30,
657526,657546,2024-12-14_20-13-12-548788,657550,20,
662637,662712,2024-12-14_20-13-17-696508,662714,75,
667762,667776,2024-12-14_20-13-22-774901,667777,14,
672886,672931,2024-12-14_20-13-27-929976,672935,45,
677995,678010,2024-12-14_20-13-33-012555,678015,15,
683140,683162,2024-12-14_20-13-38-159494,683163,22,
688284,688322,2024-12-14_20-13-43-301263,688324,38,
693395,693430,2024-12-14_20-13-48-429856,693431,35,
698520,698553,2024-12-14_20-13-53-552726,698555,33,
703640,703683,2024-12-14_20-13-58-676608,703684,43,
708748,708772,2024-12-14_20-14-03-773857,708773,24,
713865,713881,2024-12-14_20-14-08-876645,713882,16,
718974,719038,2024-12-14_20-14-14-028858,719042,64,
724083,724122,2024-12-14_20-14-19-119421,724123,39,
729196,729230,2024-12-14_20-14-24-231518,729231,34,
734315,734346,2024-12-14_20-14-29-347786,734347,31,
739436,739463,2024-12-14_20-14-34-462391,739464,27,
744569,744594,2024-12-14_20-14-39-594586,744595,25,
749681,749709,2024-12-14_20-14-44-711513,749710,28,
754793,754827,2024-12-14_20-14-49-817719,754828,34,
759909,759957,2024-12-14_20-14-54-955703,759958,48,
765020,765078,2024-12-14_20-15-00-080467,765079,58,
770142,770184,2024-12-14_20-15-05-186018,770185,42,
775263,775345,2024-12-14_20-15-10-301237,775346,82,
780371,780399,2024-12-14_20-15-15-394748,780401,28,
785501,785550,2024-12-14_20-15-20-547693,785552,49,
790610,790645,2024-12-14_20-15-25-647123,790646,35,
795718,795789,2024-12-14_20-15-30-775552,795790,71,
800852,800887,2024-12-14_20-15-35-878611,800890,35,
805989,806022,2024-12-14_20-15-41-019891,806023,33,
811102,811149,2024-12-14_20-15-46-139381,811150,47,
816210,816255,2024-12-14_20-15-51-245143,816256,45,
821353,821388,2024-12-14_20-15-56-388357,821389,35,
826473,826508,2024-12-14_20-16-01-507354,826509,35,
831582,831614,2024-12-14_20-16-06-614456,831615,32,
836695,841811,2024-12-14_20-16-11-793002,841812,5116,
841814,841851,2024-12-14_20-16-16-850010,841852,37,
846920,846944,2024-12-14_20-16-21-939566,846945,24,
852029,852050,2024-12-14_20-16-27-046646,852051,21,
857136,857170,2024-12-14_20-16-32-150033,857171,34,
862244,862269,2024-12-14_20-16-37-263679,862270,25,
867374,867409,2024-12-14_20-16-42-409136,867410,35,
872482,872511,2024-12-14_20-16-47-506120,872514,29,
877623,882729,2024-12-14_20-16-52-674616,882731,5106,
882733,882769,2024-12-14_20-16-57-763502,882770,36,
887862,887893,2024-12-14_20-17-02-890130,887894,31,
892970,892993,2024-12-14_20-17-07-990174,892994,23,
898106,898139,2024-12-14_20-17-13-135866,898140,33,
903212,908319,2024-12-14_20-17-18-372525,908320,5107,
908320,908354,2024-12-14_20-17-23-352427,908356,34,
913431,913458,2024-12-14_20-17-28-458338,913459,27,
918539,918577,2024-12-14_20-17-33-569891,918578,38,
923648,923676,2024-12-14_20-17-38-672406,923677,28,
928792,928817,2024-12-14_20-17-43-816413,928818,25,
933900,933923,2024-12-14_20-17-48-920963,933924,23,
939041,939070,2024-12-14_20-17-54-068915,939071,29,
944150,944164,2024-12-14_20-17-59-163651,944165,14,
949257,949309,2024-12-14_20-18-04-304799,949310,52,
954375,954403,2024-12-14_20-18-09-399223,954404,28,
959482,959502,2024-12-14_20-18-14-501183,959506,20,
964589,964631,2024-12-14_20-18-19-630834,964633,42,
969700,969732,2024-12-14_20-18-24-732651,969734,32,
974806,974820,2024-12-14_20-18-29-818946,974821,14,
979939,979971,2024-12-14_20-18-34-967094,979972,32,
985052,985066,2024-12-14_20-18-40-063823,985067,14,
990159,990203,2024-12-14_20-18-45-202723,990204,44,
995268,995343,2024-12-14_20-18-50-339339,995361,75,
1000403,1000431,2024-12-14_20-18-55-433340,1000436,28,
1005510,1005543,2024-12-14_20-19-00-531992,1005551,33,
1010621,1010636,2024-12-14_20-19-05-637543,1010637,15,
1015750,1015782,2024-12-14_20-19-10-781843,1015783,32,
1020860,1020888,2024-12-14_20-19-15-882775,1020889,28,
1025968,1025993,2024-12-14_20-19-20-992672,1025994,25,
1031089,1031114,2024-12-14_20-19-26-114384,1031115,25,
1036201,1036228,2024-12-14_20-19-31-229575,1036232,27,